11111111111111111111111111111111
1..............................1
11111111111111111111111111111111
1..............................1
1..............................1
1..............................1
1..............................1
1..............................1
1..............................1
1..............................1
1..............................1
1..............................1
1..............................1
1..............................1
1..............................1
1..............................1
1..............................1
1..............................1
1..............................1
111111111111111111111111111111.1
111111111111111111111111111111.1
1............................1.1
1P.1...M.1.....M......1...M....1
11111111111111111111111111111111